{
  "format": 2,
  "id": "ancient_ruins",
  "name": "断碑遗迹",
  "mapGroupId": "ancient_ruins",
  "mapGroupName": "断碑遗迹",
  "mapGroupOrder": 1000,
  "mapGroupMemberOrder": 0,
  "width": 48,
  "height": 48,
  "routeDomain": "system",
  "mapLv": 8,
  "spaceVisionMode": "isolated",
  "description": "扩展为 48x48 的残碑遗迹：西侧残碑广场承接青竹林旧道，中庭符阵区是守纹残念仍在维系的最后秩序，南部钥石回廊与东南登穹残阶把兽谷异变与天穹残宫的断裂因果连成一线。",
  "terrain": [
    "草草草草草草草草草草草草草草草草草草草草草草草草草草草草草草草草草草草草草草草草草草草草草草草草",
    "草草草草草草草草草草草草草草草草草草草草草草草草草草草草草草草草草草草草草草草草草草草草草草草草",
    "草草草草草草草草草草草草草草草草草草草草草草草草草草草草草草草草草草草草草草草草草草草草草草草草",
    "草草草草草草草草草草草草草草草草草草草草草草草草草草草草草草草草草草草草草草草草草草草草草草草草",
    "草草草草草草草草草草草草草草草草草草草草草草草草草草草草草草草草草草草草草草草草草草草草草草草草",
    "草草草草草草草草草草草草草草草草草草草草草草草草草草草草草草草草草草草草草草草草草草草草草草草草",
    "草草草草草草草草草草草草草草草草草草草草草草草草草草草草草草草草草草草草草草草草草草草草草草草草",
    "草草草草草草草草草草草草草草草草草草草草草草草草草草草草草草草草草草草草草草草草草草草草草草草草",
    "草草草草草草草草草草草草草草草草草草草草草草草草草草草草草草草草草草草草草草草草草草草草草草草草",
    "草草草草草草草草草草草草草草草草草草草草草草草草草草草草草草草草草草草草草草草草草草草草草草草草",
    "草草草草草草草草草草草草草草草草草草草草草草草草草草草草草草草草草草草草草草草草草草草草草草草草",
    "草草草草草草草草草草草草草草草草草草草草草草草草草草草草草草草草草草草草草草草草草草草草草草草草",
    "草草草草草草草草草草草草草草草草草草草草草草草草草草草草草草草草草草草草草草草草草草草草草草草草",
    "草草草草草草草草草草草草草草草草草草草草草草草草草草草草草草草草草草草草草草草草草草草草草草草草",
    "草草草草草草草草草草草草草草草草草草草草草草草草草草草草草草草草草草草草草草草草草草草草草草草草",
    "草草草草草草草草草草草草草草草草草草草草草草草草草草草草草草草草草草草草草草草草草草草草草草草草",
    "草草草草草草草草草草草草草草草草草草草草草草草草草草草草草草草草草草草草草草草草草草草草草草草草",
    "草草草草草草草草草草草草草草草草草草草草草草草草草草草草草草草草草草草草草草草草草草草草草草草草",
    "草草草草草草草草草草草草草草草草草草草草草草草草草草草草草草草草草草草草草草草草草草草草草草草草",
    "草草草草草草草草草草草草草草草草草草草草草草草草草草草草草草草草草草草草草草草草草草草草草草草草",
    "草草草草草草草草草草草草草草草草草草草草草草草草草草草草草草草草草草草草草草草草草草草草草草草草",
    "草草草草草草草草草草草草草草草草草草草草草草草草草草草草草草草草草草草草草草草草草草草草草草草草",
    "草草草草草草草草草草草草草草草草草草草草草草草草草草草草草草草草草草草草草草草草草草草草草草草草",
    "草草草草草草草草草草草草草草草草草草草草草草草草草草草草草草草草草草草草草草草草草草草草草草草草",
    "草草草草草草草草草草草草草草草草草草草草草草草草草草草草草草草草草草草草草草草草草草草草草草草草",
    "草草草草草草草草草草草草草草草草草草草草草草草草草草草草草草草草草草草草草草草草草草草草草草草草",
    "草草草草草草草草草草草草草草草草草草草草草草草草草草草草草草草草草草草草草草草草草草草草草草草草",
    "草草草草草草草草草草草草草草草草草草草草草草草草草草草草草草草草草草草草草草草草草草草草草草草草",
    "草草草草草草草草草草草草草草草草草草草草草草草草草草草草草草草草草草草草草草草草草草草草草草草草",
    "草草草草草草草草草草草草草草草草草草草草草草草草草草草草草草草草草草草草草草草草草草草草草草草草",
    "草草草草草草草草草草草草草草草草草草草草草草草草草草草草草草草草草草草草草草草草草草草草草草草草",
    "草草草草草草草草草草草草草草草草草草草草草草草草草草草草草草草草草草草草草草草草草草草草草草草草",
    "草草草草草草草草草草草草草草草草草草草草草草草草草草草草草草草草草草草草草草草草草草草草草草草草",
    "草草草草草草草草草草草草草草草草草草草草草草草草草草草草草草草草草草草草草草草草草草草草草草草草",
    "草草草草草草草草草草草草草草草草草草草草草草草草草草草草草草草草草草草草草草草草草草草草草草草草",
    "草草草草草草草草草草草草草草草草草草草草草草草草草草草草草草草草草草草草草草草草草草草草草草草草",
    "草草草草草草草草草草草草草草草草草草草草草草草草草草草草草草草草草草草草草草草草草草草草草草草草",
    "草草草草草草草草草草草草草草草草草草草草草草草草草草草草草草草草草草草草草草草草草草草草草草草草",
    "草草草草草草草草草草草草草草草草草草草草草草草草草草草草草草草草草草草草草草草草草草草草草草草草",
    "草草草草草草草草草草草草草草草草草草草草草草草草草草草草草草草草草草草草草草草草草草草草草草草草",
    "草草草草草草草草草草草草草草草草草草草草草草草草草草草草草草草草草草草草草草草草草草草草草草草草",
    "草草草草草草草草草草草草草草草草草草草草草草草草草草草草草草草草草草草草草草草草草草草草草草草草",
    "草草草草草草草草草草草草草草草草草草草草草草草草草草草草草草草草草草草草草草草草草草草草草草草草",
    "草草草草草草草草草草草草草草草草草草草草草草草草草草草草草草草草草草草草草草草草草草草草草草草草",
    "草草草草草草草草草草草草草草草草草草草草草草草草草草草草草草草草草草草草草草草草草草草草草草草草",
    "草草草草草草草草草草草草草草草草草草草草草草草草草草草草草草草草草草草草草草草草草草草草草草草草",
    "草草草草草草草草草草草草草草草草草草草草草草草草草草草草草草草草草草草草草草草草草草草草草草草草",
    "草草草草草草草草草草草草草草草草草草草草草草草草草草草草草草草草草草草草草草草草草草草草草草草草"
  ],
  "structure": [
    "墙墙墙墙墙墙墙墙墙墙墙墙墙墙墙墙墙墙墙墙墙墙墙墙墙墙墙墙墙墙墙墙墙墙墙墙墙墙墙墙墙墙墙墙墙墙墙墙",
    "墙..............................................墙",
    "墙..............................................墙",
    "墙..............................................墙",
    "墙..............................................墙",
    "墙..............................................墙",
    "墙............墙墙墙.................墙墙墙墙墙墙墙墙墙墙墙...墙",
    "墙..............墙.................墙.........墙...墙",
    "墙.....墙...石石石..墙.................墙.........墙...墙",
    "墙.....墙...石石石..墙.................墙..石石石.石..墙...墙",
    "墙.....墙...石石石..墙.................墙..石石石.石..墙...墙",
    "墙.....墙........墙.................墙..石石石.石..墙...墙",
    "墙.....墙........墙.................墙.........墙...墙",
    "墙.....墙墙墙墙.墙墙墙墙墙.................墙.........墙...墙",
    "墙................................墙.........墙...墙",
    "墙..........石.....................墙墙墙墙墙.墙墙墙墙墙...墙",
    "墙.............石................................墙",
    "墙.............石................................墙",
    "墙......石..石...石石.墙墙墙门墙墙墙门墙墙墙门墙墙墙........石石石石...墙",
    "墙..石石石石.......石..墙.............墙.石......石..石...墙",
    "墙..石..石..........墙.............墙石石......石..石...墙",
    "墙..石石石石....石.....墙.............墙石石......石石石石...墙",
    "墙...................石石石石..............石..石.....墙",
    "墙................墙..石石石石...石...墙石石.............墙",
    "墙..................................石石石石石石......墙",
    "墙................墙..石石石石...石...墙.石.石石石石石.......墙",
    "墙........石石石.....墙..石石石石...........石石石.........墙",
    "墙......石石石石石石石...墙.............墙...............墙",
    "墙....石石石石石石石石石石..墙.............墙...............墙",
    "墙....石石石石石石石石石石..墙.............墙...............墙",
    "墙....石石石石石石石石石石石.墙墙墙门墙墙墙.墙墙墙门墙墙墙...............墙",
    "墙....石石石石石石石石石石................................墙",
    "墙....石石石石石石石石石石........................石.......墙",
    "墙......石石石石石石石.......................石石石石石石石...墙",
    "墙........石石石............................石.石石...墙",
    "墙.......................................石.石石...墙",
    "墙....................................石..石.石石...墙",
    "墙.....................石石.石石.............石石石石...墙",
    "墙....................石石石石石石石..............石....墙",
    "墙.....................石石.石石....................墙",
    "墙......................................石.......墙",
    "墙..............................................墙",
    "墙..............................................墙",
    "墙..............................................墙",
    "墙..............................................墙",
    "墙..............................................墙",
    "墙..............................................墙",
    "墙墙墙墙墙墙墙墙墙墙墙墙墙墙墙墙墙墙墙墙墙墙墙墙墙墙墙墙墙墙墙墙墙墙墙墙墙墙墙墙墙墙墙墙墙墙墙墙"
  ],
  "surface": [
    "板板板板板板板板板板板板板板板板板板板板板板板板板板板板板板板板板板板板板板板板板板板板板板板板",
    "板..............................................板",
    "板...............................................",
    "板...............................................",
    "板.....板板板板板板板...................................",
    "板.....板板板板板板板...................................",
    "板.....板板板板板板板板..................................",
    "板.....板板板板板板板板板...................板板板板板板板板板.....",
    "板.....板板板径板板板板板板..................板板板板板板板板板板....",
    "板......板板径板板板板板板..................板板板板板板板板板板....",
    "板......板板径板板板板板板..................板板板板板径板板板板....",
    "板......板板径板板板板板板..................板板板板板径板板板板....",
    "板......板板径径板板板板...................板板板板板径板板板板....",
    "板........径径径板板....................板板板板板径板板板板....",
    "板.........径.......................板板板板径径板板板.....",
    "板.........径板.......................板板径径径.板......",
    "板.......板板板板板板板.......................径.........",
    "板.......板板板板板板板.....................径径径.........",
    "板......板板板板板板板板板..................板板板板板板板板板板....",
    "板..板板板板.板板板板板板板...板板板板板板板板板板板板板..板板板板板板板板..板....",
    "板..板..板.板板板板板板径径径板板板板板板板板板板板板板板板板板板板板板板板板..板....",
    "板..板板板板....板....径径板板板板板板板板板板板板板径板板板板板板板板板板板板....",
    "板.板板板板板板板.......径径径板板板板板板板板板板径径径径径板板板板板板板板......",
    "板.板板板板板板板........径径板板板板板板板板板板板板径板板板板板板板板板.......",
    "板.板路路路路路路路路路路路路路路路径路路路路路路路路路路径径径径径径板板板板板板.......",
    "板.板板板板板板板........路板板板板板板路板板板板板板径.板径板板板板板........",
    "板.板板板板板板板板板板......板板板板板板路板板板板板板径径径径板板板板板板.......",
    "板......板板板板板板板....板板板板板板路板板板板板板板..径板板板板板板.......",
    "板....板板板板板板板板板板...板板板板板板路板板板板板板板..径径径径径板板.......",
    "板....板板板板板板板板板板...板板板板板板路板板板板板板...板板板板径径径径径径径...",
    "板....板板板板板板板板板板板...板板板板路路路板板板板....板板板板板板板...板...",
    "板....板板板板板板板板板板.....径...路.........板板板板板板板.......",
    "板....板板板板板板板板板板.........路.........板板板板板板板.......",
    "板......板板板板板板板..........路.........板板板板板板板板板板....",
    "板........板板板........板板板板路板板板板......板板板板板板板板板....",
    "板...................板板板板路板板板板......板板板板板板板板板....",
    "板...................板板板板路板板板板......板板板板板板板板板....",
    "板...................板板板板路板板板板......板板板板板板板板板....",
    "板...................板板板板板板板板板......板板板板板板板板.....",
    "板...................板板板板路板板板板......板板板板板板板......",
    "板...................板板板板路板板板板..........板........",
    "板.......................路.......................",
    "板.......................路.......................",
    "板.......................板.......................",
    "板...............................................",
    "板...............................................",
    "板..............................................板",
    "板板............................................板板"
  ],
  "monsterSpawns": [
    [
      37,
      35,
      "m_ruin_guardian"
    ],
    [
      38,
      12,
      "m_bone_owl"
    ],
    [
      29,
      27,
      "m_rune_watcher"
    ],
    [
      12,
      18,
      "m_ghost_scribe"
    ]
  ],
  "portals": [
    {
      "id": "ancient_ruins:2,24",
      "targetPortalId": "bamboo_forest:43,27",
      "direction": "two_way",
      "x": 2,
      "y": 24,
      "targetMapId": "bamboo_forest",
      "targetX": 43,
      "targetY": 27,
      "kind": "portal",
      "trigger": "manual",
      "routeDomain": "inherit",
      "allowPlayerOverlap": false,
      "hidden": false
    },
    {
      "id": "ancient_ruins:9,7",
      "targetPortalId": "spirit_ridge:45,37",
      "direction": "two_way",
      "x": 9,
      "y": 7,
      "targetMapId": "spirit_ridge",
      "targetX": 45,
      "targetY": 37,
      "kind": "portal",
      "trigger": "manual",
      "routeDomain": "inherit",
      "allowPlayerOverlap": false,
      "hidden": false
    },
    {
      "id": "ancient_ruins:39,9",
      "targetPortalId": "sky_ruins:39,39",
      "direction": "two_way",
      "x": 39,
      "y": 9,
      "targetMapId": "sky_ruins",
      "targetX": 39,
      "targetY": 39,
      "kind": "portal",
      "trigger": "manual",
      "routeDomain": "inherit",
      "allowPlayerOverlap": false,
      "hidden": false
    },
    {
      "id": "ancient_ruins:44,30",
      "targetPortalId": "beast_valley:42,10",
      "direction": "two_way",
      "x": 44,
      "y": 30,
      "targetMapId": "beast_valley",
      "targetX": 42,
      "targetY": 10,
      "kind": "portal",
      "trigger": "manual",
      "routeDomain": "inherit",
      "allowPlayerOverlap": false,
      "hidden": false
    },
    {
      "id": "ancient_ruins:24,43",
      "targetPortalId": "beast_valley:24,43",
      "direction": "two_way",
      "x": 24,
      "y": 43,
      "targetMapId": "beast_valley",
      "targetX": 24,
      "targetY": 43,
      "kind": "portal",
      "trigger": "manual",
      "routeDomain": "inherit",
      "allowPlayerOverlap": false,
      "hidden": false
    },
    {
      "id": "ancient_ruins:24,22",
      "targetPortalId": "ancient_ruins_monument_hall:1,9",
      "direction": "two_way",
      "x": 24,
      "y": 22,
      "targetMapId": "ancient_ruins_monument_hall",
      "targetX": 1,
      "targetY": 9,
      "kind": "portal",
      "trigger": "manual",
      "routeDomain": "inherit",
      "allowPlayerOverlap": false,
      "hidden": false
    }
  ],
  "spawnPoint": {
    "x": 3,
    "y": 24
  },
  "time": {
    "offsetTicks": 420,
    "scale": 1,
    "light": {
      "base": 8,
      "timeInfluence": 70
    },
    "palette": {
      "dawn": {
        "tint": "#c8d4df",
        "alpha": 0.08
      },
      "dusk": {
        "tint": "#6b6f8f",
        "alpha": 0.14
      },
      "night": {
        "tint": "#1b1f31",
        "alpha": 0.24
      }
    }
  },
  "landmarks": [
    {
      "id": "lm_cracked_monument",
      "name": "裂痕主碑",
      "x": 5,
      "y": 22,
      "desc": "西侧残碑广场的主碑早已断裂，碑面残纹正是兽谷裂息外泄的最早记载。"
    },
    {
      "id": "lm_rune_hall",
      "name": "符阵中庭",
      "x": 24,
      "y": 21,
      "desc": "遗迹仅存的中庭符阵仍在勉力运转，守纹残念就在此处维系通往深处的秩序。"
    },
    {
      "id": "lm_sky_stair",
      "name": "登穹残阶",
      "x": 39,
      "y": 39,
      "desc": "踏过钥石回廊后，断裂石阶一路抬升至天穹残宫，是第三章后段的关键跃升点。"
    }
  ],
  "npcs": [
    {
      "id": "npc_ruin_scholar_spirit",
      "name": "碑灵学士",
      "x": 6,
      "y": 23,
      "char": "碑",
      "color": "#d9d2ff",
      "dialogue": "先看裂碑，再谈上路。这里不是单纯塌了，而是有人把镇压兽谷的旧纹路硬生生掰断了。",
      "role": "lore",
      "shopItems": [],
      "quests": []
    },
    {
      "id": "npc_rune_keeper",
      "name": "守纹残念",
      "x": 19,
      "y": 21,
      "char": "纹",
      "color": "#95b3ff",
      "dialogue": "中庭还能撑住，但钥石回廊已被看守撕开。去取回遗迹钥石，再斩守阶残卫，我便为你续起登穹路标。",
      "role": "quest_giver",
      "shopItems": [],
      "quests": []
    }
  ]
}
