{
  "format": 2,
  "id": "beast_valley",
  "name": "噬魂兽谷",
  "mapGroupId": "beast_valley",
  "mapGroupName": "噬魂兽谷",
  "mapGroupOrder": 1000,
  "mapGroupMemberOrder": 0,
  "width": 48,
  "height": 48,
  "routeDomain": "system",
  "mapLv": 10,
  "spaceVisionMode": "isolated",
  "description": "扩展为 48x48 的噬魂兽谷：西北谷口还留着巡山弟子死守的残营，北脊升灵界门压在崖顶，东壁鸦台和西南矿裂把支线岔路分开，真正的主线则一路沉进中央血沼与谷底裂隙。",
  "terrain": [
    "草草草草草草草草草草草草草草草草草草草草草草草草草草草草草草草草草草草草草草草草草草草草草草草草",
    "草崖崖崖崖崖崖崖崖崖崖崖崖崖崖崖崖崖崖崖崖崖崖崖崖崖崖崖崖崖崖崖崖崖崖崖崖崖崖崖崖崖崖崖崖崖崖草",
    "草崖崖崖崖崖崖崖崖崖崖崖崖崖崖崖崖崖崖崖崖草草草草草草草崖崖崖崖崖崖崖崖崖崖崖崖崖崖崖崖崖崖崖崖",
    "草崖崖崖崖崖崖崖崖崖崖崖崖崖崖崖崖崖崖崖崖草草草草草草草崖崖崖崖崖崖崖崖崖崖崖崖崖崖崖崖崖崖崖崖",
    "草崖崖崖崖崖崖崖崖崖崖崖崖崖崖崖崖崖崖崖崖草草草草草草草崖崖崖崖崖崖崖崖崖崖崖崖崖崖崖崖崖崖崖崖",
    "草崖崖崖崖崖崖崖崖崖崖崖崖崖崖崖崖崖崖崖崖草草草草草草草崖崖崖崖崖崖崖崖崖崖崖崖崖崖崖崖崖崖崖崖",
    "草崖草草草草草草草草草草草崖崖崖崖崖崖崖崖崖崖崖草崖崖崖崖崖崖崖崖崖崖崖崖崖崖崖崖崖崖崖崖崖崖崖",
    "草崖草草草草草草草草草草草崖崖崖崖崖崖崖崖崖崖崖草崖崖崖崖崖崖崖崖崖崖崖崖崖崖崖崖崖崖崖崖崖崖崖",
    "草崖草草草草草草草草草草草草草草草草草草草草草草草崖崖崖崖崖崖草草草草草草草草草草草草草崖崖崖崖",
    "草崖草草草草草草草草草草草崖崖崖崖崖崖崖崖崖崖崖草崖崖崖崖崖崖草草草草草草草草草草草草草崖崖崖崖",
    "草崖草草草草草草草草草草草草草草草草草草草草草草草草草草草草草草草草草草草草草草草草草草崖崖崖崖",
    "草崖草草草草草草草草草草草草草草草草草草草草草草草草草草草草草草草草草草草草草草草草草草崖崖崖崖",
    "草崖草草草草草草草草草草草草草草草草草草草草草草草草草草草草草草草草草草草草草草草草草草崖崖崖崖",
    "草崖崖崖崖崖崖崖崖崖崖崖崖草草草草草草草草草草草草草草草草草草草草草草草草草草草草草草草崖崖崖崖",
    "草崖崖崖崖崖崖崖崖崖崖崖崖草草草草草草草草草草草草草草草草草草草草草草草草草草草草草草草崖崖崖崖",
    "草崖崖崖崖崖崖崖崖崖崖崖崖草草草草草草草草草草草草草草草草草草草草草草草草草草草草草草草崖崖崖崖",
    "草崖崖崖崖崖崖崖崖崖崖崖崖草草草草草草草草草草草草草草草草草草草草草草草草草草草草草草草崖崖崖崖",
    "草崖崖崖崖崖崖崖崖崖崖崖崖草草草草草草草草草草草草草草草草草草草草草草草草草草草草草草草崖崖崖崖",
    "草崖崖崖崖崖崖崖崖草草草草草草草草草草草草草草草草草草草草草草草草草草草草草草草草草草草崖崖崖崖",
    "草崖崖崖崖崖崖崖崖草草草草草草草草草草草草草草草草草草草草草草草草草草草草草草草草草草草崖崖崖崖",
    "草崖崖崖崖崖崖崖崖草草草草草草草草草草草草草草草草草草草草草草草草草草草草草草草草草崖崖崖崖崖崖",
    "草崖崖崖崖崖崖崖崖草草草草草草草草草草草草草草草草草草草草草草草草草草草草草草草草草崖崖崖崖崖崖",
    "草崖崖崖崖崖崖崖崖草草草草草草草草草草草草草草草草草草草草草草草草草草草草草草草草草崖崖崖崖崖崖",
    "草崖崖崖崖崖崖崖崖草草草草草草草草草草草草崖崖崖草崖崖崖崖崖草草草草草草草草草草草草崖崖崖崖崖崖",
    "草崖崖崖崖崖崖崖崖草草草草草草草草草草草草崖崖崖草崖崖崖崖崖草草草草草草草草草草草草崖崖崖崖崖崖",
    "草崖崖崖崖崖崖崖崖草草草草草草草草草草草草崖崖崖草崖崖崖崖崖草草草草草草草草草草草草崖崖崖崖崖崖",
    "草崖崖崖崖崖崖崖崖草草草草草草草草草草草草崖崖崖草崖崖崖崖崖草草草草草草草草草草草草崖崖崖崖崖崖",
    "草崖崖崖崖崖崖崖崖草草草草草草草草草泥泥泥泥泥泥草泥泥泥泥泥泥草草草草草草草草草草草崖崖崖崖崖崖",
    "草崖崖崖崖崖崖崖崖草草草草草草草草草泥草泥泥泥泥草泥泥泥泥草泥草草草草草草草草草草草崖崖崖崖崖崖",
    "草崖崖崖崖崖崖崖崖崖崖崖崖崖崖崖崖崖泥泥沼沼沼沼草沼沼沼沼泥泥草草草草草草草草草草草崖崖崖崖崖崖",
    "草崖崖崖崖崖崖崖崖崖崖崖崖崖崖崖崖崖泥泥草沼沼沼草沼沼沼草泥泥崖崖崖崖崖崖崖崖崖崖崖崖崖崖崖崖崖",
    "草崖崖崖崖崖崖崖崖崖崖崖崖崖崖崖崖崖草泥沼沼水水草水水沼沼泥泥崖崖崖崖崖崖崖崖崖崖崖崖崖崖崖崖崖",
    "草崖崖崖崖崖崖崖崖崖草草草草草草草草草泥沼沼水水草水水沼沼泥泥崖崖崖崖崖崖崖崖崖崖崖崖崖崖崖崖崖",
    "草崖崖草草草草草草草草草草草草草崖崖泥泥沼沼水水草水水沼沼泥泥崖草草草草草草草草草草草草崖崖崖崖",
    "草崖崖草草草草草草草草草草草崖崖崖崖泥泥沼沼水水草水水沼沼泥泥崖草草草草草草草草草草草草崖崖崖崖",
    "草崖崖草草草草草草草草草草草崖崖崖崖泥泥沼沼水水草水水沼沼泥泥崖草草草草草草草草草草草草崖崖崖崖",
    "草崖崖草草草草草草草草草草草崖崖崖崖泥泥沼沼水水草水水沼沼泥泥崖草草草草草草草草草草草草崖崖崖崖",
    "草崖崖草草草草草草草草草草草崖崖崖崖泥泥沼草草草草草草草沼泥泥崖草草草草草草草草草草草草崖崖崖崖",
    "草崖崖草草草草草草草草草草草崖崖崖崖泥泥沼草草草草草草草沼泥草草草草草草草草草草草草草草崖崖崖崖",
    "草崖崖草草草草草草草草草草草崖崖崖崖泥草泥草草草草草草草泥草泥崖草草草草草草草草草草草草崖崖崖崖",
    "草崖崖草草草草草草草草草草草崖崖崖崖泥泥泥草草草草草草草泥泥泥崖草草草草草草草草草草草草崖崖崖崖",
    "草崖崖草草草草草草草草草草草崖崖崖崖泥泥泥草草草草草草草泥泥泥崖草草草草草草草草草草草草崖崖崖崖",
    "草崖崖草草草草草草草草草草草崖崖崖崖崖崖崖草草草草草草草崖崖崖崖草草草草草草草草草草草草崖崖崖崖",
    "草崖崖崖崖崖崖崖崖崖崖崖崖崖崖崖崖崖崖崖崖草草草草草草草崖崖崖崖草草草草草草草草草草草草崖崖崖崖",
    "草崖崖崖崖崖崖崖崖崖崖崖崖崖崖崖崖崖崖崖崖草草草草草草草崖崖崖崖草草草草草草草草草草草草崖崖崖崖",
    "草崖崖崖崖崖崖崖崖崖崖崖崖崖崖崖崖崖崖崖崖崖崖崖崖崖崖崖崖崖崖崖崖崖崖崖崖崖崖崖崖崖崖崖崖崖崖崖",
    "草崖崖崖崖崖崖崖崖崖崖崖崖崖崖崖崖崖崖崖崖崖崖崖崖崖崖崖崖崖崖崖崖崖崖崖崖崖崖崖崖崖崖崖崖崖崖草",
    "草草崖崖崖崖崖崖崖崖崖崖崖崖崖崖崖崖崖崖崖崖崖崖崖崖崖崖崖崖崖崖崖崖崖崖崖崖崖崖崖崖崖崖崖崖草草"
  ],
  "structure": [
    "墙墙墙墙墙墙墙墙墙墙墙墙墙墙墙墙墙墙墙墙墙墙墙墙墙墙墙墙墙墙墙墙墙墙墙墙墙墙墙墙墙墙墙墙墙墙墙墙",
    "墙..............................................墙",
    "墙..............................................墙",
    "墙..............................................墙",
    "墙..............................................墙",
    "墙..............................................墙",
    "墙..............................................墙",
    "墙..............................................墙",
    "墙..............................................墙",
    "墙..............................................墙",
    "墙..............................................墙",
    "墙..............................................墙",
    "墙..........................石........石石石石.......墙",
    "墙................石石..石.........................墙",
    "墙..............................................墙",
    "墙.............树树树...........树树树................墙",
    "墙.................石........石........石.石.石......墙",
    "墙..............................................墙",
    "墙..............................................墙",
    "墙..............................................墙",
    "墙.........树....................................墙",
    "墙.........树树.石..石..............................墙",
    "墙........树.......石.................石...........墙",
    "墙........树...........................石.........墙",
    "墙.............石..石.............................墙",
    "墙...................................石..........墙",
    "墙.................石...................石........墙",
    "墙..............................................墙",
    "墙..................石.........石.................墙",
    "墙..............................................墙",
    "墙...................石.......石..................墙",
    "墙..............................................墙",
    "墙..............................................墙",
    "墙..............................................墙",
    "墙..............................................墙",
    "墙....石....石....................................墙",
    "墙.......树树..........................石..石.......墙",
    "墙.......树树.....................................墙",
    "墙..............................................墙",
    "墙..................石.........石.................墙",
    "墙....石....石...........石...石........石....石......墙",
    "墙..............................................墙",
    "墙..............................................墙",
    "墙..............................................墙",
    "墙..............................................墙",
    "墙..............................................墙",
    "墙..............................................墙",
    "墙墙墙墙墙墙墙墙墙墙墙墙墙墙墙墙墙墙墙墙墙墙墙墙墙墙墙墙墙墙墙墙墙墙墙墙墙墙墙墙墙墙墙墙墙墙墙墙"
  ],
  "surface": [
    "板板板板板板板板板板板板板板板板板板板板板板板板板板板板板板板板板板板板板板板板板板板板板板板板",
    "板..............................................板",
    "板....................板板板板板板板....................",
    "板....................板板板板板板板....................",
    "板....................板路路板路路板....................",
    "板....................板板板径板板板....................",
    "板.......................径.......................",
    "板....板板板板板板.............径.......................",
    "板...板路路路路路路.路路路路路路路板板板板板径......板..板板板板板...板板....",
    "板....板板板板板板.............径......板板板板板板板板板板板板.....",
    "板....板板板板板板....................路路路径路路路路路路路板板....",
    "板..............................板板板径板板板板板板板板.....",
    "板...............板板路路路路路路路板板板板..板板板径板板板板板板..板....",
    "板...............板板板板板板板板路板板板板..板板板径板板板板板板板板板....",
    "板...............板板板板板板板板路板板径径..径板板径板板板板板板板板板....",
    "板................板板板板板板板路板板板...板板板径板板板板板板板板板....",
    "板...............板板板板板板板板路板板板板..板板板径板板板板板板板板板....",
    "板...............板板板板板板板板路板板板板..板板板径板板板板板板板板板....",
    "板..............径.....板板板路板板板板..板板板径板板板板板板板板板....",
    "板..............径.....板板板路板板板板..板板径板板板板板板板板板板....",
    "板...........板板板径板板板.....路........径..............",
    "板...........板板板径板板板.....路........径..............",
    "板...........板板板径板板板..径径径径径径.....板径板板板板板板........",
    "板...........径径径径径径板.....径.......板径板板板板板板........",
    "板...........板板板板板板板.....径.......板径径径径径径径........",
    "板...........板板板板板板板.....径.......板板板板板板板板........",
    "板.................板.....径.......板板板板板板板板........",
    "板.......................径.......板板板板板板板板........",
    "板..................板....径....板..................",
    "板.......................径.......................",
    "板...................板...径...板...................",
    "板.................径.....径.......................",
    "板.........径径径径径径径径径.....径.......................",
    "板.............径径........板.............径.........",
    "板...........径径..........径.............径.........",
    "板...板板板板板板板径............径.........板板板板径板板板......",
    "板...板板板板..板.............径.........板板板板径板板板......",
    "板...板板板板..板..........板板板径板板板......板板板板径板板板......",
    "板...板板板板板板板..........板板板径板板板..径径径径径径径径径板板板......",
    "板...板板板路路路路........板.板板板径板板板.板....板板板板板板板板......",
    "板...板板板板板板板..........板板板径板板板......板板板板板板板板......",
    "板....................板板板径板板板......板板板板板板板板......",
    "板....................板板板径板板板....................",
    "板....................板板路板路板板....................",
    "板....................板板板板板板板....................",
    "板...............................................",
    "板..............................................板",
    "板板............................................板板"
  ],
  "monsterSpawns": [
    [
      15,
      18,
      "m_valley_wolf"
    ],
    [
      17,
      23,
      "m_valley_wolf"
    ],
    [
      35,
      14,
      "m_blood_crow"
    ],
    [
      38,
      18,
      "m_blood_crow"
    ],
    [
      24,
      30,
      "m_valley_alpha"
    ],
    [
      35,
      24,
      "m_valley_serpent"
    ],
    [
      24,
      38,
      "m_valley_emperor"
    ]
  ],
  "portals": [
    {
      "id": "beast_valley:4,8",
      "targetPortalId": "bamboo_forest:24,42",
      "direction": "two_way",
      "x": 4,
      "y": 8,
      "targetMapId": "bamboo_forest",
      "targetX": 24,
      "targetY": 42,
      "kind": "portal",
      "trigger": "manual",
      "routeDomain": "inherit",
      "allowPlayerOverlap": false,
      "hidden": false
    },
    {
      "id": "beast_valley:42,10",
      "targetPortalId": "ancient_ruins:44,30",
      "direction": "two_way",
      "x": 42,
      "y": 10,
      "targetMapId": "ancient_ruins",
      "targetX": 44,
      "targetY": 30,
      "kind": "portal",
      "trigger": "manual",
      "routeDomain": "inherit",
      "allowPlayerOverlap": false,
      "hidden": false
    },
    {
      "id": "beast_valley:6,39",
      "targetPortalId": "black_iron_mine:43,39",
      "direction": "two_way",
      "x": 6,
      "y": 39,
      "targetMapId": "black_iron_mine",
      "targetX": 43,
      "targetY": 39,
      "kind": "portal",
      "trigger": "manual",
      "routeDomain": "inherit",
      "allowPlayerOverlap": false,
      "hidden": false
    },
    {
      "id": "beast_valley:24,43",
      "targetPortalId": "ancient_ruins:24,43",
      "direction": "two_way",
      "x": 24,
      "y": 43,
      "targetMapId": "ancient_ruins",
      "targetX": 24,
      "targetY": 43,
      "kind": "portal",
      "trigger": "manual",
      "routeDomain": "inherit",
      "allowPlayerOverlap": false,
      "hidden": false
    },
    {
      "id": "beast_valley:24,4",
      "targetPortalId": "spirit_ridge:23,46",
      "direction": "two_way",
      "x": 24,
      "y": 4,
      "targetMapId": "spirit_ridge",
      "targetX": 23,
      "targetY": 46,
      "kind": "portal",
      "trigger": "manual",
      "routeDomain": "inherit",
      "allowPlayerOverlap": false,
      "hidden": false
    },
    {
      "id": "beast_valley:24,33",
      "targetPortalId": "beast_valley_blood_altar:1,9",
      "direction": "two_way",
      "x": 24,
      "y": 33,
      "targetMapId": "beast_valley_blood_altar",
      "targetX": 1,
      "targetY": 9,
      "kind": "portal",
      "trigger": "manual",
      "routeDomain": "inherit",
      "allowPlayerOverlap": false,
      "hidden": false
    }
  ],
  "spawnPoint": {
    "x": 5,
    "y": 8
  },
  "time": {
    "offsetTicks": 330,
    "scale": 1,
    "light": {
      "base": 20,
      "timeInfluence": 35
    },
    "palette": {
      "dawn": {
        "tint": "#b7b0a7",
        "alpha": 0.06
      },
      "dusk": {
        "tint": "#6a544d",
        "alpha": 0.12
      },
      "night": {
        "tint": "#1b1620",
        "alpha": 0.24
      }
    }
  },
  "landmarks": [
    {
      "id": "lm_valley_rift",
      "name": "谷底裂隙",
      "x": 24,
      "y": 34,
      "desc": "裂谷最深处的血沼一直在往外翻泡，狼主就盘在这条裂隙边吞吃残灵与尸骨。"
    },
    {
      "id": "lm_valley_lift_gate",
      "name": "升灵界门",
      "x": 24,
      "y": 4,
      "desc": "北脊崖顶还钉着旧升灵界门，真正能从兽谷翻上灵脊岭的人，已经算把凡人的最后一段险路走完了。"
    }
  ],
  "npcs": [
    {
      "id": "npc_wounded_patrol",
      "name": "重伤巡山弟子",
      "x": 8,
      "y": 8,
      "char": "伤",
      "color": "#ff9e9e",
      "dialogue": "谷口还能站人，是因为狼主还没把这边当正餐。你若真要下到裂隙里，就先想好自己准备拿什么命去换那颗谷核。",
      "role": "warning",
      "shopItems": [],
      "quests": []
    }
  ]
}
