{
  "format": 2,
  "id": "prison",
  "name": "监牢",
  "mapGroupId": "prison",
  "mapGroupName": "监牢",
  "mapGroupOrder": 1000,
  "mapGroupMemberOrder": 0,
  "width": 20,
  "height": 20,
  "routeDomain": "system",
  "mapLv": 1,
  "spaceVisionMode": "isolated",
  "description": "四面空空，只余一片无遮无拦的囚场。",
  "terrain": [
    "草草草草草草草草草草草草草草草草草草草草",
    "草草草草草草草草草草草草草草草草草草草草",
    "草草草草草草草草草草草草草草草草草草草草",
    "草草草草草草草草草草草草草草草草草草草草",
    "草草草草草草草草草草草草草草草草草草草草",
    "草草草草草草草草草草草草草草草草草草草草",
    "草草草草草草草草草草草草草草草草草草草草",
    "草草草草草草草草草草草草草草草草草草草草",
    "草草草草草草草草草草草草草草草草草草草草",
    "草草草草草草草草草草草草草草草草草草草草",
    "草草草草草草草草草草草草草草草草草草草草",
    "草草草草草草草草草草草草草草草草草草草草",
    "草草草草草草草草草草草草草草草草草草草草",
    "草草草草草草草草草草草草草草草草草草草草",
    "草草草草草草草草草草草草草草草草草草草草",
    "草草草草草草草草草草草草草草草草草草草草",
    "草草草草草草草草草草草草草草草草草草草草",
    "草草草草草草草草草草草草草草草草草草草草",
    "草草草草草草草草草草草草草草草草草草草草",
    "草草草草草草草草草草草草草草草草草草草草"
  ],
  "structure": [
    "....................",
    "....................",
    "....................",
    "....................",
    "....................",
    "....................",
    "....................",
    "....................",
    "....................",
    "....................",
    "....................",
    "....................",
    "....................",
    "....................",
    "....................",
    "....................",
    "....................",
    "....................",
    "....................",
    "...................."
  ],
  "surface": [
    "板板板板板板板板板板板板板板板板板板板板",
    "板板板板板板板板板板板板板板板板板板板板",
    "板板板板板板板板板板板板板板板板板板板板",
    "板板板板板板板板板板板板板板板板板板板板",
    "板板板板板板板板板板板板板板板板板板板板",
    "板板板板板板板板板板板板板板板板板板板板",
    "板板板板板板板板板板板板板板板板板板板板",
    "板板板板板板板板板板板板板板板板板板板板",
    "板板板板板板板板板板板板板板板板板板板板",
    "板板板板板板板板板板板板板板板板板板板板",
    "板板板板板板板板板板板板板板板板板板板板",
    "板板板板板板板板板板板板板板板板板板板板",
    "板板板板板板板板板板板板板板板板板板板板",
    "板板板板板板板板板板板板板板板板板板板板",
    "板板板板板板板板板板板板板板板板板板板板",
    "板板板板板板板板板板板板板板板板板板板板",
    "板板板板板板板板板板板板板板板板板板板板",
    "板板板板板板板板板板板板板板板板板板板板",
    "板板板板板板板板板板板板板板板板板板板板",
    "板板板板板板板板板板板板板板板板板板板板"
  ],
  "spawnPoint": {
    "x": 10,
    "y": 10
  },
  "time": {
    "offsetTicks": 0,
    "scale": 1,
    "light": {
      "base": 22,
      "timeInfluence": 6
    },
    "palette": {}
  }
}
