{
  "format": 2,
  "id": "sky_ruins",
  "name": "天穹残宫",
  "mapGroupId": "sky_ruins",
  "mapGroupName": "天穹残宫",
  "mapGroupOrder": 1000,
  "mapGroupMemberOrder": 0,
  "width": 48,
  "height": 48,
  "routeDomain": "system",
  "mapLv": 15,
  "spaceVisionMode": "isolated",
  "description": "扩展为 48x48 的天穹残宫：南侧升穹落台承接灵脊岭与遗迹残阶，中段观星台是残影守住的最后据点，外庭猎场散落着星铁雨后的猎者与傀壳，最北端断桥尽头则是噬星兽盘踞的封柱核心井。",
  "terrain": [
    "草草草草草草草草草草草草草草草草草草草草草草草草草草草草草草草草草草草草草草草草草草草草草草草草",
    "草空空空空空空空空空空空空空空空空空空空空空空空空空空空空空空空空空空空空空空空空空空空空空空草",
    "草空空空空空空空空空空空空空空空空空空空空空空空空空空空空空空空空空空空空空空空空空空空空空空空",
    "草空空空空空空空空空空空空空空空空空空空空空空空空空空空空空空空空空空空空空空空空空空空空空空空",
    "草空空空空空空空空空空空空空空空空空草草草草草草草草草草草草草空空空空空空空空空空空空空空空空空",
    "草空空空空空空空空空空空空空空空空空草草草草草草草草草草草草草空空空空空空空空空空空空空空空空空",
    "草空空空空空空空空空空空空空空空空空草草草草草草草草草草草草草空空空空空空空空空空空空空空空空空",
    "草空空空空空空空空空空空空空空空空空草草草草草草草草草草草草草空空空空空空空空空空空空空空空空草",
    "草云云云云云云云云草草草草草草空空空草草草草草草草草草草草草草空空空草草草草草草云云云云云云云草",
    "草云云云云云云云云草草草草草草空空空空空空空空草草草空空空空空空空空草草草草草草云云云云云云云云",
    "草云云云云云云云云草草草草草草草草草草空空空空草草草空空空空草草草草草草草草草草云云云云云云云云",
    "草云云云云云云云云草草草草草草空空空空空空空空草草草空空空空空空空空草草草草草草云云云云云云云云",
    "草云云云云云云云云草草草草草草空空空空空空空空草草草空空空空空空空空草草草草草草云云云云云云云草",
    "草空空空空空空空空空空空草草草草草草草草草草草草草草草草草草草草草草草草草空空空空空空空空空空草",
    "草空空空空空空空空空空空空草草草草草草草草草草草草草草草草草草草草草草草空空空空空空空空空空空空",
    "草空空空空空空空空空空空空空草草草草草草草草草草草草草草草草草草草草草空空空空空空空空空空空空空",
    "草空空空空空空空空空空空空空草草草草草草草草草草草草草草草草草草草草草空空空空空空空空空空空空空",
    "草空空空空空空空空空空空空空草草草草草草草草草草草草草草草草草草草草草空空空空空空空空空空空空空",
    "草空空空空空空空空空空空空空草草草草草草草草草草草草草草草草草草草草草空空空空空空空空空空空空空",
    "草空空空空空空空空空空空空空草草草草草草草草草草草草草草草草草草草草草空空空空空空空空空空空空空",
    "草空空空空空空空空空空空空空草草草草草草草草草草草草草草草草草草草草草空空空空空空空空空空空空空",
    "草空空空空空空空空空空空空空草草草草草草草草草草草草草草草草草草草草草空空空空空空空空空空空空空",
    "草空空空空空空空空空空空空空空空空空草草草草草草草草草草草草草空空空空空空空空空空空空空空空空空",
    "草空空空空空空空空空空空空空空空草草草草草草草草草草草草草草草草草空空空空空空空空空空空空空空空",
    "草空空空空空空空空空空空空空空空草草草草草草草草草草草草草草草草草空空空空空空空空空空空空空空空",
    "草空空空空空空空空空空空空空空空草草草草草草草草草草草草草草草草草空空空空空空空空空空空空空空空",
    "草空空空空空空空空空空空空空空空草草草草草草草草草草草草草草草草草空空空空空空空空空空空空空空空",
    "草空空空空空空空空空空空空空空空草草草草草草草草草草草草草草草草草空空空空空空空空空空空空空空空",
    "草空空空空空空空空空空空空空空空草草草草草草草草草草草草草草草草草空空空空空空空空空空空空空空空",
    "草空空空空空空空空空空空空空空空草草草草草草草草草草草草草草草草草空空空空空空空空空空空空空空草",
    "草云云云云云云云云云云云云云云云草草草草草草草草草草草草草草草草草云草草草草草草草草草云云云云草",
    "草云云云云草草草草草草草草草草云草空空空空空空草草草空空空空空空草云草草草草草草草草草云云云云云",
    "草云云云云草草草草草草草草草草云草空空空空空空草草草空空空空空空草草草草草草草草草草草云云云云云",
    "草云云云云草草草草草草草草草草云草空空空空空空草草草空空空空空空空云草草草草草草草草草云云云云云",
    "草云云云云草草草草草草草草草草草草空空空空空空草草草空空空空空空空云草草草草草草草草草云云云云云",
    "草云云云云草草草草草草草草草草云空空空空空空空草草草空空空空空空空云草草草草草草草草草云云云云云",
    "草云云云云草草草草草草草草草草云空空空空空空空草草草空空空空空空空云云草草草草草草草草草云云云云",
    "草云云云云草草草草草草草草草草云空空空空空空空草草草空空空空空空空云云草草草草草草草草草云云云云",
    "草云云云云草草草草草草草草草草云空空空空空空草草草草草空空空空空空云云草草草草草草草草草云云云云",
    "草云云云云云云云云云云云云云云云空空空空空空空草草草空空空空空空空云云草草草草草草草草草云云云云",
    "草云云云云云云云云云云云云云云云云云霞草草草草草草草草草草草草草草草草草霞霞霞霞霞霞霞霞云云云云",
    "草云云云云云云云云云云云云云云云云云霞霞霞霞霞霞霞霞霞霞霞霞云云云云霞霞霞霞霞霞霞霞霞云云云云云",
    "草云云云云云云云云云云云云云云云云云霞霞霞霞霞霞霞霞霞霞霞霞云云云云霞霞霞霞霞霞霞霞霞云云云云云",
    "草云云云云云云云云云云云云云云云云云霞霞霞霞霞霞草霞霞霞霞霞霞云云云云云云云云云云云云云云云云云",
    "草云云云云云云云云云云云云云云云云云草草草草草草草草草草草草草云云云云云云云云云云云云云云云云云",
    "草云云云云云云云云云云云云云云云云云云云云云云云草云云云云云云云云云云云云云云云云云云云云云云云",
    "草云云云云云云云云云云云云云云云云云云云云云云云云云云云云云云云云云云云云云云云云云云云云云云草",
    "草草云云云云云云云云云云云云云云云云云云云云云云云云云云云云云云云云云云云云云云云云云云云云草草"
  ],
  "structure": [
    "墙墙墙墙墙墙墙墙墙墙墙墙墙墙墙墙墙墙墙墙墙墙墙墙墙墙墙墙墙墙墙墙墙墙墙墙墙墙墙墙墙墙墙墙墙墙墙墙",
    "墙..............................................墙",
    "墙..............................................墙",
    "墙..............................................墙",
    "墙..............................................墙",
    "墙..............................................墙",
    "墙......................石.石.....................墙",
    "墙..............................................墙",
    "墙..............................................墙",
    "墙..............................................墙",
    "墙..........石........................石..........墙",
    "墙..............................................墙",
    "墙..............................................墙",
    "墙.................门...........门................墙",
    "墙..............................................墙",
    "墙..............................................墙",
    "墙................石.............石...............墙",
    "墙..............................................墙",
    "墙..................石..石...石..石.................墙",
    "墙..............................................墙",
    "墙..............................................墙",
    "墙.................门.....门.....门................墙",
    "墙..............................................墙",
    "墙...................门...门...门..................墙",
    "墙..............................................墙",
    "墙..............................................墙",
    "墙..............................................墙",
    "墙....................石.....石...................墙",
    "墙..............................................墙",
    "墙..............................................墙",
    "墙..............................................墙",
    "墙..............................................墙",
    "墙...................................石..........墙",
    "墙.......石..石..........................石........墙",
    "墙..............................................墙",
    "墙..............................................墙",
    "墙..............................................墙",
    "墙..............................................墙",
    "墙.....................石...石....................墙",
    "墙..............................................墙",
    "墙..............................................墙",
    "墙..............................................墙",
    "墙..............................................墙",
    "墙..............................................墙",
    "墙..............................................墙",
    "墙..............................................墙",
    "墙..............................................墙",
    "墙墙墙墙墙墙墙墙墙墙墙墙墙墙墙墙墙墙墙墙墙墙墙墙墙墙墙墙墙墙墙墙墙墙墙墙墙墙墙墙墙墙墙墙墙墙墙墙"
  ],
  "surface": [
    "板板板板板板板板板板板板板板板板板板板板板板板板板板板板板板板板板板板板板板板板板板板板板板板板",
    "板..............................................板",
    "板...............................................",
    "板...............................................",
    "板.................板板板板板板板板板板板板板.................",
    "板.................板板板板板板板板板板板板板.................",
    "板.................板板板板板板板板板板板板板.................",
    "板.................板板板板板板板板板板板板板................板",
    "板........板板板板板板...板板板板板板板板板板板板板...板板板板板板.......板",
    "板........板板板板板板........路路路........板板板板板板........",
    "板........板板板板板路路路路路....路路路....路路路路路板板板板板........",
    "板........板板板板板板........路路路........板板板板板板........",
    "板........板板板板板板........路路路........板板板板板板.......板",
    "板...........板板板板板板板板板板板板路板板板板板板板板板板板板..........板",
    "板............板板板板板板板板板板板径板板板板板板板板板板板............",
    "板.............板板板板板板板板板板板板板板板板板板板板板.............",
    "板.............板板板板板板板板板板板板板板板板板板板板板.............",
    "板.............板板板板板板板板板板板板板板板板板板板板板.............",
    "板.............板板径板板板板板板板板板板板板板板板径板板.............",
    "板.............板板板板板板板板板径板径板板板板板板板板板.............",
    "板.............板板板板板板板板板板径板板板板板板板板板板.............",
    "板.............板板板板板板板板板板板板板板板板板板板板板.............",
    "板.................路路径路路路路路路路径路路.................",
    "板...............板板板板板板板板板板板板板板板板板...............",
    "板...............板板板板板板板板板板板板板板板板板...............",
    "板...............板板径板板板板板板板板板板板径板板...............",
    "板...............板板板板板板板板板板板板板板板板板...............",
    "板...............板板板板板板板板板板板板板板板板板...............",
    "板...............板板板板板板板板板板板板板板板板路...............",
    "板...............板板板板板板板板板板板板板板板板路..............板",
    "板...............路路路路路路路路径路路路路路路路路.板板板板板板板板板....板",
    "板....板板板板板板板板板板.路......路径路......路.板板板板板板板板板.....",
    "板....板板板板板板板板板板.路......路径路......路路路板板板板板板板板.....",
    "板....板板板板板板板板板板.路......路径路........板板板板板板板板板.....",
    "板....板板板板板板板板板路路路......路径路........板板板径板板板板板.....",
    "板....板板板板板板板径板板........路径路........板板板板板板板板板.....",
    "板....板板板板板板板板板板........路径路.........板板板板路路路路板....",
    "板....板板板板板板板板板板........路径路.........板板板板路板板板板....",
    "板....板板板板板板板板板板.......板路径路板........板板板板路板板板板....",
    "板......................路径路.........板板板板板板板板板....",
    "板..................路路路路路径路路路路路路路路路路路............",
    "板...............................................",
    "板...............................................",
    "板.......................板.......................",
    "板.................板板板板板板路板板板板板板.................",
    "板.......................路.......................",
    "板..............................................板",
    "板板............................................板板"
  ],
  "monsterSpawns": [
    [
      10,
      10,
      "m_void_hunter"
    ],
    [
      35,
      10,
      "m_void_hunter"
    ],
    [
      8,
      35,
      "m_void_hunter"
    ],
    [
      39,
      34,
      "m_void_hunter"
    ],
    [
      18,
      16,
      "m_sky_puppet"
    ],
    [
      30,
      16,
      "m_sky_puppet"
    ],
    [
      24,
      7,
      "m_star_devourer"
    ]
  ],
  "portals": [
    {
      "id": "sky_ruins:24,43",
      "targetPortalId": "spirit_ridge:24,3",
      "direction": "two_way",
      "x": 24,
      "y": 43,
      "targetMapId": "spirit_ridge",
      "targetX": 24,
      "targetY": 3,
      "kind": "portal",
      "trigger": "manual",
      "routeDomain": "inherit",
      "allowPlayerOverlap": false,
      "hidden": false
    },
    {
      "id": "sky_ruins:39,39",
      "targetPortalId": "ancient_ruins:39,9",
      "direction": "two_way",
      "x": 39,
      "y": 39,
      "targetMapId": "ancient_ruins",
      "targetX": 39,
      "targetY": 9,
      "kind": "portal",
      "trigger": "manual",
      "routeDomain": "inherit",
      "allowPlayerOverlap": false,
      "hidden": false
    },
    {
      "id": "sky_ruins:24,5",
      "targetPortalId": "sky_ruins_core_well:1,9",
      "direction": "two_way",
      "x": 24,
      "y": 5,
      "targetMapId": "sky_ruins_core_well",
      "targetX": 1,
      "targetY": 9,
      "kind": "portal",
      "trigger": "manual",
      "routeDomain": "inherit",
      "allowPlayerOverlap": false,
      "hidden": false
    }
  ],
  "spawnPoint": {
    "x": 24,
    "y": 42
  },
  "time": {
    "offsetTicks": 560,
    "scale": 1,
    "light": {
      "base": 18,
      "timeInfluence": 48
    },
    "palette": {
      "dawn": {
        "tint": "#d9d5ff",
        "alpha": 0.06
      },
      "dusk": {
        "tint": "#5f6fa8",
        "alpha": 0.12
      },
      "night": {
        "tint": "#161b34",
        "alpha": 0.22
      }
    }
  },
  "landmarks": [
    {
      "id": "lm_sky_core",
      "name": "封柱核心井",
      "x": 24,
      "y": 5,
      "desc": "断桥尽头的核心井还在往外渗出裂天余波，噬星兽就伏在井边啃噬最后的封柱骨架。"
    },
    {
      "id": "lm_sky_altar",
      "name": "残宫观星台",
      "x": 24,
      "y": 24,
      "desc": "观星台是残宫中少数还没完全塌穿的台面，站在这里能同时看见灵脊岭、断碑遗迹和更高处的断裂封天。",
      "container": {
        "grade": "saint",
        "refreshTicks": 4800,
        "drops": [
          {
            "itemId": "star_metal",
            "name": "星陨金",
            "type": "material",
            "count": 2,
            "chance": 0.8
          },
          {
            "itemId": "void_shard",
            "name": "虚蚀碎片",
            "type": "material",
            "count": 1,
            "chance": 0.65
          },
          {
            "itemId": "equip.deepvein_core",
            "name": "空劫符坠",
            "type": "equipment",
            "count": 1,
            "chance": 0.08
          }
        ],
        "lootPools": []
      }
    }
  ],
  "npcs": [
    {
      "id": "npc_sky_observer",
      "name": "观星残影",
      "x": 24,
      "y": 25,
      "char": "星",
      "color": "#e5e6ff",
      "dialogue": "别把这里当宝地。星铁雨先砸穿了残宫，封柱才跟着断。你若想替地上争口喘息，就先把那些还替旧天守门的壳子和猎者清干净。",
      "role": "quest_giver",
      "shopItems": [],
      "quests": []
    }
  ]
}
