{
  "format": 2,
  "id": "spirit_ridge",
  "name": "灵脊岭",
  "mapGroupId": "spirit_ridge",
  "mapGroupName": "灵脊岭",
  "mapGroupOrder": 1000,
  "mapGroupMemberOrder": 0,
  "width": 48,
  "height": 48,
  "routeDomain": "system",
  "mapLv": 12,
  "spaceVisionMode": "isolated",
  "description": "扩展为 48x48 的灵脊岭：西坡是能盘旋上行的缓岭旧道，东侧则是坠向兽谷与残宫的断崖危台；中央寒潭与守岭关门把第四章的试炼层层抬高，最上方升穹阵则把凡武尽头推到真正的修仙门槛前。",
  "terrain": [
    "崖崖崖崖崖崖崖崖崖崖崖崖崖崖崖崖崖崖崖崖崖崖崖崖崖崖崖崖崖崖崖崖崖崖崖崖崖崖崖崖崖崖崖崖崖崖崖崖",
    "崖崖崖崖崖崖崖崖崖崖崖崖崖崖崖崖崖崖崖崖崖崖草草草草草崖崖崖崖崖崖崖崖崖崖崖崖崖崖崖崖崖崖崖崖崖",
    "崖崖崖崖崖崖崖崖崖崖崖崖崖崖崖崖崖崖崖崖崖崖草草草草草崖崖崖崖崖崖崖崖崖崖崖崖崖崖崖崖崖崖崖崖崖",
    "崖崖崖崖崖崖崖崖崖崖崖崖崖崖崖崖崖崖崖崖崖崖草草草草草崖崖崖崖崖崖崖崖崖崖崖崖崖崖崖崖崖崖崖崖崖",
    "崖崖崖崖崖崖崖崖崖崖崖崖崖崖崖崖崖崖崖崖崖崖草草草草草崖崖崖崖崖崖崖崖崖崖崖崖崖崖崖崖崖崖崖崖崖",
    "崖崖崖崖崖崖崖崖崖崖崖崖崖崖崖崖崖崖崖崖崖崖崖草草草崖崖崖崖崖崖崖崖崖崖崖崖崖崖崖崖崖崖崖崖崖崖",
    "崖崖崖崖崖崖崖崖崖崖崖崖崖崖崖崖崖崖崖崖崖崖崖草草草崖崖崖崖崖崖崖崖崖崖崖崖崖崖崖崖崖崖崖崖崖崖",
    "崖崖崖崖崖崖崖崖崖崖崖崖崖崖崖崖崖崖崖崖草草草草草草草草草崖崖崖崖崖崖崖崖崖崖崖崖崖崖崖崖崖崖崖",
    "崖崖崖崖崖崖崖崖崖崖崖崖崖崖崖崖崖崖崖草草草草草草草草草草草崖崖崖崖崖崖崖崖崖崖崖崖崖崖崖崖崖崖",
    "崖崖崖崖崖崖崖崖崖崖崖崖崖崖崖崖崖崖崖草草草草草草草草草草草崖崖崖崖崖崖崖崖崖崖崖崖崖崖崖崖崖崖",
    "崖崖崖崖崖崖崖崖崖崖崖崖崖崖崖崖崖崖崖草草草草草草草草草草草崖崖崖崖崖崖崖崖崖崖崖崖崖崖崖崖崖崖",
    "崖崖崖崖崖崖崖崖崖崖崖崖崖崖崖崖崖崖崖草草草草草草草草草草草崖崖崖崖崖崖崖崖崖崖崖崖崖崖崖崖崖崖",
    "崖崖崖崖崖崖崖崖崖崖崖崖崖崖崖崖崖崖崖草草草草草草草草草草草崖崖崖崖崖崖崖崖崖崖崖崖崖崖崖崖崖崖",
    "崖崖崖崖崖崖崖崖崖崖崖崖崖崖崖崖崖崖崖草草草草草草草草草草草崖崖崖崖崖崖崖崖崖崖崖崖崖崖崖崖崖崖",
    "崖崖崖崖崖崖崖崖崖崖崖崖崖崖崖崖崖崖崖草草草草草草草草草草草崖崖崖崖崖崖崖崖崖崖崖崖崖崖崖崖崖崖",
    "崖崖崖崖崖崖崖崖崖崖崖崖崖崖崖崖崖崖崖草草草草草草草草草草草崖崖崖崖崖崖崖崖崖崖崖崖崖崖崖崖崖崖",
    "崖崖崖崖崖崖崖崖崖崖崖崖崖崖崖崖崖崖草草草水水水水水草草草崖崖崖崖崖崖崖草崖草崖草崖崖崖崖崖崖崖",
    "崖崖崖崖崖崖崖崖草草草草草草草崖崖崖草草水水水沼水水水草草崖崖崖草草草草草草草草草草草草崖崖崖崖",
    "崖崖崖崖崖崖草草草草草草草草草崖崖崖草草水水沼水水沼水草草草崖草草草草草草草草草草草草草草崖崖崖",
    "崖崖崖崖草草草草草草草草草草草崖崖崖草草水沼水水沼水水草草崖草草草草草草草草草草草草草草草草崖崖",
    "崖崖崖草草草草草草草草草草草草草崖草草草草水水水沼水草草草草草草草草草草草草草草草草草草草草崖崖",
    "崖崖草草草草草草草草草草草草草草草草草草草水水水水草草草草草草草草草草草草草草草草草草草草草崖崖",
    "崖崖草草草草草草草草草草草草草草崖草草草草草草草草草草草草草草草草草草草草草草草草草草草草草崖崖",
    "崖崖草草草草草草草草草草草草草草崖草草草草草草草草草草草草草草草草草草草草草草草草草草草草草崖崖",
    "崖崖草草草草草草草草草草草草草草崖草草草草草草草草草草草草草草草草草草草草草草草草草草草草草崖崖",
    "崖崖草草草草草草草草草草草草草草草草草草草草草草草草草草草草草草草崖草草草草草草草草草草草草崖崖",
    "崖崖草草草草草草草草草草草草草崖崖崖崖草草草崖崖草崖崖草草草崖崖崖崖草草草草草草草草草草草草崖崖",
    "崖崖崖草草草草草草草草草草草草崖崖崖崖草草崖崖崖草崖崖草草草草崖崖草草草草草草草草草草草草草崖崖",
    "崖崖崖草草草草草草草草草草草草崖崖崖草草草崖崖草草草崖崖草草草崖崖草草草草草草草草草草草草草崖崖",
    "崖崖崖草草草草草草草草草草草草崖崖草草草崖崖草草草草草崖崖草草草崖崖草草草草草草草草草草草草崖崖",
    "崖崖崖草草草草草草草草草草草草崖崖草草崖草草草草草草草草草草草草草草草草草草草草草草草草草崖崖崖",
    "崖崖崖草草草草草草草草草草草草崖崖草草草草草草草草草草草草草草草草草草草草草草草草草草草崖崖崖崖",
    "崖崖草草草草草草草草草草草草崖崖崖草草草草草草草草草草草草草草草草草草草草草草草草草草崖崖崖崖崖",
    "崖崖草草草草草草草草草草草草崖崖崖草草草草草草草草草草草草草草草草草草草草草草草草草崖崖崖崖崖崖",
    "崖草草草草草草草草草草草草崖崖崖崖草草草草草草草草草草草草草草草草草草草草草草草草草崖崖崖崖崖崖",
    "崖草草草草草草草草草草草草崖崖崖崖草草草草草草草草草草草草草草草草草草草草草草草草崖崖崖崖崖崖崖",
    "草草草草草草草草草草草草崖崖崖崖草草草草草草草草草草草草草草草草草草草草草草草草草崖崖崖崖崖崖崖",
    "崖草草草草草草草草草草草崖崖崖崖草草草草草草草草草草草草草草草草草草草草草草草草草草草草草草草草",
    "崖草草草草草草草草草草草崖崖崖崖草草草草草草草草草草草草草草草草草草草草草草草草草草草草崖崖崖崖",
    "崖草草草草草草草草草草草草草草草草草草草草草草草草草草草草草草草草草草草草草草草草草草崖崖崖崖崖",
    "崖草草草草草草草草草草崖崖崖崖崖崖草草草草草草草草草草草草草草草草草草草草草草草草草崖崖崖崖崖崖",
    "崖草草草草草草草草草草崖崖崖崖崖崖草草草草草草草草草草草草草草草草草草草草草草草草草崖崖崖崖崖崖",
    "崖草草草草草草草草草草崖崖崖崖崖崖草草草草草草草草草草草草草草草草草草草草草草草草草崖崖崖崖崖崖",
    "崖崖草草草草草草草草草草草草草草草草草草草草草草草草草草草草草草草草草草草草草草草崖崖崖崖崖崖崖",
    "崖崖崖草草草草草草草崖崖崖崖崖崖崖崖崖草草草草草草草草草草草草草草草草草草草草草草崖崖崖崖崖崖崖",
    "崖崖崖草草草草草草崖崖崖崖崖崖崖崖崖崖草草草草草草草草草草草草草草草草草草草草草崖崖崖崖崖崖崖崖",
    "崖崖崖崖草草崖崖崖崖崖崖崖崖崖崖崖崖崖草草草草草草草草草草草草草草草草草草草草崖崖崖崖崖崖崖崖崖",
    "崖崖崖崖草草崖崖崖崖崖崖崖崖崖崖崖崖崖崖崖崖崖草崖崖崖崖崖崖崖崖崖崖崖崖崖崖崖崖崖崖崖崖崖崖崖崖"
  ],
  "structure": [
    "................................................",
    "................................................",
    "................................................",
    "................................................",
    "................................................",
    "................................................",
    "................................................",
    "....................石石石...石石石...................",
    "...................石.........石..................",
    "................................................",
    "................................................",
    "................................................",
    "................................................",
    "................................................",
    "................................................",
    "...................石石石树...树..石..................",
    "..................石石................石.石.石.......",
    "................................石石石石............",
    "...............................石石...........石...",
    "..............................石石...石......石..石..",
    ".........树.........树.........树石石.............石..",
    "................................................",
    "........石............................石..........",
    "...........石.............................石......",
    "................................................",
    "......石....石.................................石..",
    "........................................石.......",
    "........石.......................................",
    ".............石.....................石.........石..",
    "................................................",
    "......................石石.石石.....................",
    ".....................石石.石石......................",
    "................................................",
    "................................................",
    ".................................树.......石......",
    "................................................",
    "......................................石.........",
    ".....................石...石.....树................",
    "................................................",
    "................................................",
    ".....................石.....石....................",
    "................................................",
    "........................................石.......",
    "................................................",
    "................................................",
    "................................................",
    "................................................",
    "................................................"
  ],
  "surface": [
    "................................................",
    "......................板板板板板.....................",
    "......................板板路板板.....................",
    "......................板路板路板.....................",
    "......................板板路板板.....................",
    ".......................径路径......................",
    ".......................径路径......................",
    "....................板板板径路径板板板...................",
    "...................板板板板径路径板板板板..................",
    "...................板板板板板路板板板板板..................",
    "...................板板板板板板板板板板板..................",
    "...................板板板板板板板板板板板..................",
    "...................板板板板路板路板板板板..................",
    "...................板板板板板板板板板板板..................",
    "...................板板板板径板径板板板板..................",
    "...................板板板.径径径.板板板..................",
    "..................板板板.....板板板.......板.板.板.......",
    "..................板板.......板板...板板板板板板板板板板板板....",
    "..................板板.......板板板.板板板板板板板板板板板板板板...",
    "........板板板板板.....板板.......板板.板板板板板板板板板板板板板板板板..",
    ".......板板.板板板板...板板.板.....板板板.板板板板板板板板板板板板板板板板..",
    "......板板板板板板板板板径径板板板板....板板板板板板板径板板板板板板板板板板板板板..",
    ".....板板板板板板板板板板径.板板板板板板板板板板板板板板板径板板板板板板板板板板板板板..",
    "....板板板板板板板板板板板径.板板板板板板板板板板板板板板径板板板板板板板板板板板板板板..",
    "....板板板板板板板板板板板径.板板板板板板板板板板板板板板板径径径径板板板板板板板板板板..",
    "....板板板板板板板板板板板径径径径板板板路板板路路板板路路路路.板板板板板板板板板板板板..",
    "....板板板板板板板板板板板.........路.........板板板板板板板板板板板板..",
    "....板板板板板板板板板板板.........路........板板板板板板板板板板板板板..",
    "....板板板板板板板板板板板.........路........板板板板板板板板板板板板板..",
    "....板板板板板板板板板板板.........路.........板板板板板板板板板板板板..",
    ".....板板板板板板板板板板.......板板路板板......径板板板板板板板板板板板...",
    ".....................板板路板板.......板板板板板板板板板板板....",
    ".....................板板路板板.......板板板板板板板板板板.....",
    "..................板板板板径路径板板板板....板板板板板板板板板......",
    "..板板板板板板板板板......板板板板板径路径板板板板板....板板板板板板板板......",
    "..板板板板板板板板板......板板板板板径路径板板板板板...板板板板板板板板.......",
    "路板路路路路路路路板板......板板板板板径路径板板板板板...板板板板板板板板.......",
    "..板板板板板板板板板......板板板板板径路径板板板板板...板板板板板板板板路路路路板路路",
    "..板板板板板板板板板......板板板板板板路路路板板板板板板..板板板板板板板板板板....",
    "..板板板板板板板板路路路路路路路路板板板板板径路径板板板板板板..板板板板板板板板板.....",
    "..板板板板板板板板板......板板板板板板径板径板板板板板板..板板板板板板板板......",
    "..板板板板板板板板板......板板板板板板径路径板板板板板板..板板板板板板板板......",
    "..板板板板板板板板板......板板板板板径路板路径板板板板板..板板板板板板板板......",
    "..板板板板板板板路路路路路路路路路板板板板径路径板板板板板..................",
    "...板板板板板板板.........板板板板径板板板板板板..................",
    ".......................径........................",
    ".......................板........................",
    ".....板.................径........................"
  ],
  "monsterSpawns": [
    [
      9,
      25,
      "m_spirit_tiger"
    ],
    [
      39,
      25,
      "m_spirit_tiger"
    ],
    [
      26,
      21,
      "m_frost_crane"
    ],
    [
      23,
      36,
      "m_frost_crane"
    ],
    [
      24,
      10,
      "m_ridge_ghost"
    ]
  ],
  "portals": [
    {
      "id": "spirit_ridge:24,3",
      "targetPortalId": "sky_ruins:24,43",
      "direction": "two_way",
      "x": 24,
      "y": 3,
      "targetMapId": "sky_ruins",
      "targetX": 24,
      "targetY": 43,
      "kind": "portal",
      "trigger": "manual",
      "routeDomain": "inherit",
      "allowPlayerOverlap": false,
      "hidden": false
    },
    {
      "id": "spirit_ridge:1,36",
      "targetPortalId": "yunlai_town:62,16",
      "direction": "two_way",
      "x": 1,
      "y": 36,
      "targetMapId": "yunlai_town",
      "targetX": 62,
      "targetY": 16,
      "kind": "portal",
      "trigger": "manual",
      "routeDomain": "inherit",
      "allowPlayerOverlap": false,
      "hidden": false
    },
    {
      "id": "spirit_ridge:5,47",
      "targetPortalId": "wildlands:24,4",
      "direction": "two_way",
      "x": 5,
      "y": 47,
      "targetMapId": "wildlands",
      "targetX": 24,
      "targetY": 4,
      "kind": "portal",
      "trigger": "manual",
      "routeDomain": "inherit",
      "allowPlayerOverlap": false,
      "hidden": false
    },
    {
      "id": "spirit_ridge:23,46",
      "targetPortalId": "beast_valley:24,4",
      "direction": "two_way",
      "x": 23,
      "y": 46,
      "targetMapId": "beast_valley",
      "targetX": 24,
      "targetY": 4,
      "kind": "portal",
      "trigger": "manual",
      "routeDomain": "inherit",
      "allowPlayerOverlap": false,
      "hidden": false
    },
    {
      "id": "spirit_ridge:45,37",
      "targetPortalId": "ancient_ruins:9,7",
      "direction": "two_way",
      "x": 45,
      "y": 37,
      "targetMapId": "ancient_ruins",
      "targetX": 9,
      "targetY": 7,
      "kind": "portal",
      "trigger": "manual",
      "routeDomain": "inherit",
      "allowPlayerOverlap": false,
      "hidden": false
    },
    {
      "id": "spirit_ridge:24,11",
      "targetPortalId": "spirit_ridge_old_gate:1,9",
      "direction": "two_way",
      "x": 24,
      "y": 11,
      "targetMapId": "spirit_ridge_old_gate",
      "targetX": 1,
      "targetY": 9,
      "kind": "portal",
      "trigger": "manual",
      "routeDomain": "inherit",
      "allowPlayerOverlap": false,
      "hidden": false
    }
  ],
  "spawnPoint": {
    "x": 2,
    "y": 34
  },
  "time": {
    "offsetTicks": 500,
    "scale": 1,
    "light": {
      "base": 28,
      "timeInfluence": 40
    },
    "palette": {
      "dawn": {
        "tint": "#d8e2ef",
        "alpha": 0.06
      },
      "dusk": {
        "tint": "#8195b5",
        "alpha": 0.1
      },
      "night": {
        "tint": "#18253d",
        "alpha": 0.2
      }
    }
  },
  "landmarks": [
    {
      "id": "lm_ridge_gate",
      "name": "岭顶关门",
      "x": 24,
      "y": 12,
      "desc": "真正的守岭关门立在寒潭之上，跨过这里才算摸到凡武尽头与练气门缝的交界。",
      "container": {
        "grade": "heaven",
        "refreshTicks": 3600,
        "drops": [
          {
            "itemId": "ridge_beast_claw",
            "name": "岭兽爪",
            "type": "material",
            "count": 2,
            "chance": 0.8
          },
          {
            "itemId": "frost_essence",
            "name": "霜华精粹",
            "type": "material",
            "count": 1,
            "chance": 0.55
          },
          {
            "itemId": "equip.deepvein_core",
            "name": "凝灵戒",
            "type": "equipment",
            "count": 1,
            "chance": 0.1
          }
        ],
        "lootPools": []
      }
    },
    {
      "id": "lm_ridge_sky_lift",
      "name": "升穹阵",
      "x": 24,
      "y": 3,
      "desc": "守岭老修看守的旧升穹阵，只有真正跨过灵岭试炼的人，才有资格继续上行去碰天穹残宫。"
    }
  ],
  "npcs": [
    {
      "id": "npc_ridge_sage",
      "name": "守岭老修",
      "x": 24,
      "y": 24,
      "char": "修",
      "color": "#b0d6ff",
      "dialogue": "下头是还没塌干净的人间路，上头是已经开始掉下来的天门。你若连这道岭都站不稳，就别谈替谁叩门。",
      "role": "quest_giver",
      "shopItems": [],
      "quests": []
    }
  ]
}
