{
  "id": "wildlands",
  "name": "荒野",
  "width": 50,
  "height": 50,
  "tiles": [
    "##################################################",
    "#,,,,,,,,,,,,,,,,,,,,,,,,,,,,,,,,,,,,,,,,,,,,,,,,#",
    "#,,:,,,,,,,,,,,,,,,,,,,,,,,,,,,,,,,,,,,,,,,,,,,,,#",
    "#,,:,,,,,,,,,,,,,,,,,,,,,,,,,,,,,,,,,,,,,,,,,,,,,#",
    "#,,:,,,,,,,,,,,,,,,,,,,,,,,,,,,,,,,,,,,,,,,,,,,,,#",
    "#,,:,,,,,,,,,,,,,,,,,,,,o,,,,,,,,,,,,,,,,,,,,,,,,#",
    "#,,:,,,,,,,,,,,,,,,,,,,,,o,,,,,,,,,,,,,,,,,,,,,,,#",
    "#,,:,,,,,,,,,,,,,,,,,,,,,,,,,,,,,,,,,,,,,,,,,,,,,#",
    "#,,T,,,,,,,,,,,,,,,,,,,,,,,,,,,,,,,,,,,,,,,,,,,,,#",
    "#,,:T,,,,,,,,,,,,,,,,,,,,,,,,,,,,,,,,,,,,,,,,,,,,#",
    "#,,=========ooooooooo,,,,,,,,,,,,,,,,,,,,,,,,,,,,#",
    "#,,,,,,,,,,,o.......o,,,,,,,,,,,,,,,,,,,,,,,,,,,,#",
    "#,,,,,,,,,,,o.......o,,,,,,,,,,,,,,,,,,,,,,,,T,,,#",
    "#,,,,,,,,,,,o.......o,,,,,,,,,,,,,,,,,,,,,,,,,T,,#",
    "#,,,,,,,,,,,o.......o,,,,,,,,,,,,,,,,,,,,,,,,,,,,#",
    "#,,,,,,,,,,,o.......o,,,,,,,,,,,,,,,,,,,,,,,,,,,,#",
    "#,,,,,,,,,,,ooooooooo,,,,,,,,,,,,,,,,,,,,,,,,,,,,#",
    "#,,,,,,,,,,,,,,,,,,,,,,,,,,,,,,,,,,,,,,,,,,,,,,,,#",
    "#,,,,,,,,,,,,,,,,,,,,,,,,,,,TT,TT,TT,,,,,,,,,,,,,#",
    "#,,,,,,,,,,,,,,,,,,,,,,,,,,,T,TT,TT,T,,,,,,,,,,,,#",
    "#,,,,,,,,,,,,,,,,,,,,,,,,,,,,TT,TT,TT,,,,,,,,,,,,#",
    "#,,,,,,,,,,,,,,,,,,,,,,,,,,,TT,TT,TT,,,,,,,,,,,,,#",
    "#,,,,,,,,,,,,,,,,,,,,,,,,,,,T,TT,TT,T,,,,,,,,,,,,#",
    "#,,,,,,,,,,,,,,,,,,,,,,,,,,,,TT,TT,TT,,,,,,,,,,,,#",
    "#,,,,,,,,,,,,,,,,,,,,,,,,,,,TT,TT,TT,,,,,,,,,,,,,#",
    "#,,,,,,,,,,,,,,,,,,,,,,,,,,,,,,,,,,,,,,,,,,,,,,,,#",
    "#,,,,,;%~~~~~~~%;,,,,,,,,,,,,,,,,,,,,,,,,,,,,,,,,#",
    "#,,,,;%~~~~~~~~~%;,,,,,,,,,,,,,,,,,,,,,,,,,,,,,,,#",
    "#,,,,;%~~~~~~~~~%;,,,,,,,,,,,,,,,,,,,,,,,,,,,,,,,#",
    "#,,,,;%~~~~~~~~~%;,,,,,,,,,,,,,,,,,,,,,,,,,,,,,,,#",
    "#,,,;%~~~~~~~~~~~%;,,,,,,,,,,,,,,,,,,,,,,,,,,,,,,#",
    "#,,,,;%~~~~~~~~~%;,,,,,,,,,,,,,,,,,,,,,,,,,,,,,,,#",
    "#,,,,;%~~~~~~~~~%;,,,,,,,,,,,,,,,,,,,,,,,,,,,,,,,#",
    "#,,,,;%~~~~~~~~~%;,,,,,,,,,,,,,,,,,,,,,,,,,,,,,,,#",
    "#,,,,,;%~~~~~~~%;,,,,,,,,,,,,,,,,,,,,,,,,,,,,,,,,#",
    "#,,,,,,,,,,,,,,,,,,,,,,,,,,,,,,,,,,,,,,,o,,,,,,,,#",
    "#,,,,,,,,,,,,,,,,,,,,,,,,,,,,,,,,,,,,,,,,o,,,,,,,#",
    "#,,,,,,,,,,,,,,,,,,,,,,,,,,,,,,,,,,,,,,,,,,,,,,,,#",
    "#,,,,,,,,,,,,,,,,,,,,,,,,,,,,,,,,,,,,,,,,,,,,,,,,#",
    "#,,,,,,,,,,,,,,,,,,,,,,,,,,,,,,,,,,,,,,,,,,,,,,,,#",
    "#,,,,,,,,,,,,,,,,,,,,,,,,,,,,,,,,,,,,,,,,,,,,,,,,#",
    "#,,,,,,,,,,,,,,,,,,,,,,,,,,,,,,,,,,,,,,,,,,,,,,,,#",
    "#,,,,,,,,,,,,,,,,,,,,,,,,,,,,,,,,,,,,,,,,,,,,,,,,#",
    "#,,,,,,,,,,,,,,,,,,,,,,,,,,,,,,,,,,,,,,,,,,,,,,,,#",
    "#,,,,,,,,,,,,,,,,,,,,,,,,,,,,,,,,,,,,,,,,,,,,,,,,#",
    "#,,,,,,,,,,,,,,,,,,,,,,,,,,,,,,,,,,,,,,,,,,,,,,,,#",
    "#,,,,,,,,,,,,,,,,,,,,,,,,,,,,,,,,,,,,,,,,,,,,,,,,#",
    "#,,,,,,,,,,,,,,,,,,,,,,,,,,,,,,,,,,,,,,,,,P,,,,,,#",
    "#,,,,,,,,,,,,,,,,,,,,,,,,,,,,,,,,,,,,,,,,,,,,,,,,#",
    "##################################################"
  ],
  "portals": [
    {
      "x": 42,
      "y": 47,
      "targetMapId": "spawn",
      "targetX": 20,
      "targetY": 20
    },
    {
      "x": 8,
      "y": 45,
      "targetMapId": "bamboo_forest",
      "targetX": 5,
      "targetY": 27
    },
    {
      "x": 24,
      "y": 10,
      "targetMapId": "spirit_ridge",
      "targetX": 3,
      "targetY": 27
    }
  ],
  "dangerLevel": 2,
  "recommendedRealm": "Entry-Minor",
  "spawnPoint": {
    "x": 2,
    "y": 2
  },
  "npcs": [
    {
      "id": "npc_hunter_luo",
      "name": "洛猎户",
      "x": 6,
      "y": 9,
      "char": "猎",
      "color": "#f2a65a",
      "role": "quest_hint",
      "dialogue": "荒野最危险的不是妖兽，是会埋伏的活人。"
    },
    {
      "id": "npc_wild_recluse",
      "name": "野修客",
      "x": 25,
      "y": 12,
      "char": "修",
      "color": "#b4a7d6",
      "role": "lore",
      "dialogue": "想从武意跨入仙路，先学会驾驭心念。"
    }
  ],
  "monsterSpawns": [
    {
      "id": "m_wild_boar",
      "x": 18,
      "y": 24
    },
    {
      "id": "m_swamp_lizard",
      "x": 10,
      "y": 30
    },
    {
      "id": "m_wild_bandit",
      "x": 27,
      "y": 14
    },
    {
      "id": "m_mire_spider",
      "x": 9,
      "y": 28
    },
    {
      "id": "m_dust_vulture",
      "x": 34,
      "y": 22
    }
  ],
  "landmarks": [
    {
      "id": "lm_wild_obelisk",
      "name": "荒野残碑",
      "x": 24,
      "y": 10,
      "desc": "碑文提示矿洞与遗迹都通向同一片兽谷。"
    },
    {
      "id": "lm_bandit_firepit",
      "name": "匪营篝火",
      "x": 27,
      "y": 14,
      "desc": "荒野匪徒聚集点，常有小股巡逻。",
      "container": {
        "grade": "mystic",
        "refreshTicks": 2400,
        "drops": [
          {
            "itemId": "bandit_insignia",
            "name": "匪徒腰牌",
            "type": "material",
            "count": 2,
            "chance": 0.85
          },
          {
            "itemId": "frost_heart_paste",
            "name": "寒心膏",
            "type": "consumable",
            "count": 1,
            "chance": 0.45
          },
          {
            "itemId": "equip.step_boots",
            "name": "游侠靴",
            "type": "equipment",
            "count": 1,
            "chance": 0.12
          }
        ]
      }
    },
    {
      "id": "lm_mire_pool",
      "name": "阴沼毒潭",
      "x": 9,
      "y": 29,
      "desc": "毒蛛巢穴边缘，丝材与毒材产出密集。"
    }
  ],
  "terrainProfileId": "yellow_frontier"
}
